11111111111111
100100C0000011
10011111011111
10P011001E0011
11111111111111