1111111111111
1001000000C01
1001111101111
1P0011E000001
1111111111111