11111111111111
100000C0000011
100C0000000111
10P011000E0011
11111111111111