1111111111111
1001EEC000C01
1001111101111
10P011E010001
1111111111111