1111111111111
1001000000C01
1001111100111
1P0011E000001
1111111111111