1111111111111
100000C000001
100C000000011
10P011000E001
1111111111111